50.ox
.....o..........o......o..o...o...o..o.o......o...
...o......oo....o...oo...o....oo.....o....o..o....
....o...........ooo.......o................o......
...o.o.o....o..o......o...o.......o....o.oo..o..o.
...o.............o.......o.oo.o...oo..o..o........
.o...o.....oo.o.o....o.oo...o..o.o...o.o...o....o.
................o.o..o.....o....o.....o...........
oo.............o......o.o.o........o..o......o....
..........o...........ooo..o.......o..o..........o
...o.o....o.......ooo..o.o..o...oo...o............
.o..o.......o..............o...o.ooooo.o....o.....
...o.oo.o.o........o..oo....o.........oo..........
....oooo...o...o..o.o...oo....o.....oo..o.......o.
.......oo...oo..............o....oo...............
......o.o.......o.....o..................oo.......
..o.o.oo.o....o......o....oo.o....o...o......o....
....o.o..o...........o.o.........o.o...o........o.
.....o.o..o..o......o.o....o...o.......o.o....o..o
o......o.......o.o.o...........oo....o.....oo.o...
...o...o..o....o.....o..............o..o...o..o.o.
oo.o.o...o..............o.o..........o.....o..ooo.
.o.........o.oo..oo....o..oo.............o.o..o...
ooooo.o.o..o.........ooo.....o..o....oo...o.......
.o...oo..o......o.....o..........oo............o..
.oo.......o.......o...o.........o...........o.....
..o.oo.....o..o.o..o........oo..o.....o........o..
......o.o.......o..o.......o...o....oo..o.o.o.....
..o.o..o..o..oo........o...................o.oo...
..o..o.....oo..o..o....o.......o..o...............
.ooo....o......o..oo.oo.........oo......o...o.....
........oo.....oo....oo.....o...o..o..o.o...o..o..
..........o..o.......o........o..o.........o......
ooo.......o..o....oo....o.oo.o.....o.......o.....o
.o.....o..o.o...........o..o..oo........o...o.....
.o..o..........o..............o.......o....o.....o
..o....o....o....o.o.o.............o......oo......
.....o...o......ooo....o...oooo....oo...o....oo...
o.............o.........oo.......o...oo........ooo
..o....o..o.o..o....o.......o..............o.o....
.....o....o..........o.........o....oo..o.........
oo.............o.o..o............o.o........o...o.
..o...ooo.o..o...o..o...o....ooo...o..o.o...o.....
.....o.......o.........o...o...o........oo..oo....
..............o.....o.o..o.o..o.o......o...o.o...o
.......o..............o.........o.oo.......oo.....
o...o.....o.o....o.o...o...o.o......o.....o....o..
o..........o....o......o.......o....o...........oo
o....o....o....o..ooo...o..............o..........
...o......oo........oooo.oo...o..o.o...o..o..oo.oo
.oo.........o...o.o.o.....o.....ooo.o...o..o.o....
